1111111111111111111
1111P11111C00C01111
100000100000C101111
1011101000C01C01111
1CMM0M0001101C01111
1000111MM0001C01111
1010111100111C01111
1010011C00001C01111
10C1011111001C01111
11110000C10E1C01111
1111111111111111111
